"filename", "language", "Java", "Properties", "comment", "blank", "total"
"c:\Users\汪晨旸\Desktop\实训\代码\后端\src\main\java\com\mayikt\service\App.java", "Java", 11, 0, 15, 3, 29
"c:\Users\汪晨旸\Desktop\实训\代码\后端\src\main\java\com\mayikt\service\Mapper\UserMapper.java", "Java", 22, 0, 0, 5, 27
"c:\Users\汪晨旸\Desktop\实训\代码\后端\src\main\java\com\mayikt\service\config\WebConfig.java", "Java", 15, 0, 0, 6, 21
"c:\Users\汪晨旸\Desktop\实训\代码\后端\src\main\java\com\mayikt\service\entity\Result.java", "Java", 15, 0, 0, 5, 20
"c:\Users\汪晨旸\Desktop\实训\代码\后端\src\main\java\com\mayikt\service\entity\UserEntity.java", "Java", 33, 0, 0, 7, 40
"c:\Users\汪晨旸\Desktop\实训\代码\后端\src\main\java\com\mayikt\service\interceptor\LogParamsInterceptor.java", "Java", 27, 0, 19, 8, 54
"c:\Users\汪晨旸\Desktop\实训\代码\后端\src\main\java\com\mayikt\service\service\UserService1.java", "Java", 39, 0, 1, 5, 45
"c:\Users\汪晨旸\Desktop\实训\代码\后端\src\main\java\com\mayikt\service\service\UserService2.java", "Java", 39, 0, 1, 3, 43
"c:\Users\汪晨旸\Desktop\实训\代码\后端\src\main\java\com\mayikt\service\service\UserService3.java", "Java", 39, 0, 1, 4, 44
"c:\Users\汪晨旸\Desktop\实训\代码\后端\src\main\java\com\mayikt\service\service\UserService4.java", "Java", 39, 0, 1, 3, 43
"c:\Users\汪晨旸\Desktop\实训\代码\后端\src\main\java\com\mayikt\service\service\UserService5.java", "Java", 39, 0, 1, 4, 44
"c:\Users\汪晨旸\Desktop\实训\代码\后端\src\main\java\com\mayikt\service\service\main.java", "Java", 126, 0, 2, 16, 144
"c:\Users\汪晨旸\Desktop\实训\代码\后端\src\main\resources\application.properties", "Properties", 0, 5, 0, 1, 6
"c:\Users\汪晨旸\Desktop\实训\代码\后端\src\test\java\com\example\demo\Demo1ApplicationTests.java", "Java", 9, 0, 0, 5, 14
"Total", "-", 453, 5, 41, 75, 574